WWWWWWWWW0WWWWWWWWW
W00000000000000000W
W00000000000000000W
W0WWW0WWWWWWWWWWW0W
W0W0000000000000W0W
W0W0000000000000W0W
W0WWWWWWWWW0WWWWWWW
W0WW000000000000W0W
W00W000000000000W0W
000W000000W00000W00
W0WW000000W0000000W
W000000000W0000000W
WWWWWWWW0WWWWWWWW0W
W0000000000000W000W
WWW0WWWWWWWWWWW0WWW
W0000000000W000000W
W000000W000000000PW
WWWWWWWWWWWWWWWWWWW
